1111111111111111111
1333333333333333331
1311131113131113111
1311131113131113331
1333333333333333131
1311131114111311131
1311131144411311131
1333331144411311131
1111311111111333331
1333313333333311131
1311113111111311131
1333333333331333331
1311111113111311111
1333333333333333331
1111111111111111111