1111111111111111111111111111111111
1133333331333333333331313333333331
1331313133313111111131313333333331
1311313111113133333331313333333331
1331313333313131111133313333333331
1131311111113133333333313333333331
1331333333333333333333313333333331
1311111111133311111111313111111331
1333333333333333333333333333333331
1333333333333333333333333333333331
1333333333333333333333333333333331
1333333333333333333333333333333331
1333333333333333333333333333333331
1333333333333333333333333333333331
1333333333333333333333333333333331
1333333333333333333333333333333331
1333333333333333333333333333333331
1333333333333333333333333333333331
1333333333333333333333333333333331
1111111111111111111111111111111111
