1111111111111111111
1333333333333333331
1311313111113131131
1333313333333133331
1311111313113111131
1314441313113333331
1314441333333113131
1314111111111313131
1313333333331313131
1333113113113333331
1311113113113111131
1333313333333133331
1311313111113131131
1333333333333333331
1111111111111111111