1111111111111111111
1333333333333333331
1311111113131111131
1333333333131333331
1311131311133311131
1313331333111113131
1333131313100013331
1131133313100013131
1333131313110113131
1313331333333333131
1311131311111311131
1333333333333333331
1311111113111111131
1333333333333333331
1111111111111111111