1111111111111111111
1333333333333333331
1313131311113131131
1311133333313333331
1313110111311131131
1333100011333333331
1113100013313113111
1333111113113333331
1113333333133113111
1333111131131133331
1313331333333331131
1311133311131133331
1313111311131131131
1333333333333333331
1111111111111111111