1111111111111111111
1311333333111333331
1333313113333311131
1131113333111333131
1133333113333313131
1331313313111413331
1311311313144413131
1333333333144413331
1313111113111113131
1313333333333333131
1313113111113113131
1313113333333113131
1313333131113113131
1333113331333333331
1111111111111111111
