1111111111111111111
1111111111111111111
1111111111111111111
1111111111111111111
1110000000111111111
1110111110111111111
1110111110111111111
1110111110111111111
1110000000111111111
1111111111111111111
1111111111111111111
1111111111111111111
1111111111111111111
1111111111111111111
1111111111111111111